00 00 00 00 00 00 00 00 00 00 00 14 04 04 13 00 00 00 13 00 00 00 00 00 00 00 00 00 00 00 00 00
00 00 17 17 17 17 17 17 17 17 00 14 04 04 13 00 00 00 13 00 00 00 00 00 00 00 00 00 00 00 00 00
00 14 22 22 22 22 22 22 22 22 13 14 04 04 13 00 00 00 13 00 00 00 00 00 00 00 00 00 00 00 00 00
00 14 22 22 22 22 22 22 22 22 13 14 04 04 13 00 00 00 13 00 00 00 00 00 00 00 00 00 00 00 00 00
00 14 22 22 22 22 22 22 22 22 13 14 04 04 13 00 00 00 13 00 00 00 00 00 00 00 00 00 00 00 00 00
00 14 22 22 22 22 22 22 22 22 13 14 04 04 13 00 00 00 05 00 00 00 00 00 00 00 00 00 00 00 00 00
00 00 15 15 15 15 15 15 15 15 00 14 04 04 13 00 00 00 11 05 00 00 00 00 00 00 00 00 00 00 00 00
00 00 17 17 17 17 17 17 17 17 00 14 04 04 13 00 00 00 09 11 05 16 16 16 16 16 16 00 00 16 16 16
00 14 22 22 22 22 22 22 22 22 13 14 04 04 13 00 00 00 00 09 01 01 01 01 01 01 01 07 08 01 01 01
00 14 22 22 22 22 22 22 22 22 13 14 04 04 19 17 17 17 17 17 17 17 17 17 17 17 17 04 04 00 00 00
00 14 22 22 22 22 22 22 22 22 13 14 04 04 04 04 04 04 04 04 04 04 04 04 04 04 04 04 04 00 00 00
00 14 22 22 22 22 22 22 22 22 13 00 20 04 04 04 04 04 04 04 04 04 04 04 04 04 04 04 21 00 00 00
00 00 15 15 15 15 15 15 15 15 00 00 00 15 15 15 15 15 15 15 15 15 15 15 15 15 15 15 00 00 00 00
00 00 00 00 00 00 00 00 00 00 00 00 00 00 00 00 00 00 00 00 00 00 00 00 00 00 00 00 00 00 00 00
01 05 00 00 00 00 00 00 00 00 00 00 00 00 00 00 00 00 00 00 00 00 00 00 00 00 00 00 00 00 06 01
01 01 05 16 16 16 16 16 16 16 16 16 16 16 16 16 16 16 16 16 16 16 16 16 16 16 16 16 16 06 01 01
02 02 01 01 01 01 01 01 01 01 01 01 01 01 01 01 01 01 01 01 01 01 01 01 01 01 01 01 01 01 02 02
02 02 02 02 02 02 02 02 02 02 02 02 02 02 02 02 02 02 02 02 02 02 02 02 02 02 02 02 02 02 02 02